....+....
...+A+...
+++B.F+++
+..+.+..+
C+.E.+G.H
.D.......