+...A+.A+A.++++++++A
++++.+..+..+.A...+..
...+.+..+++++++A.+.A
A+++++.+..+......+.+
..+.A..+..+++AAA++++
.++.++++++....+...+.
.+..+..+.+.+A.+...+.
.++++..+.+++.A+++++.
A....A++..+.......+.
++++..+A.A++AA+++++.
...++++...+....+..+.
A+.+....+++.++++A++.
.+.+.A+.+...+.....+.
.++++++.A.A.A.A++++.
.+.A..+...+....+..+.
.+++.+++A.+++.A+.A+.
.+.+.+...++.+.....+.
A+.+.+..++..+.A+++A.
.+.+.++++..A++++.A+.
.+A+A.............+A